Visele despre copii sau bebeluși pot fi atât motive de îngrijorare, cât și de bucurie. Iată ce semnifică ele, în funcție de modul în care cei mici apar în relație cu tine. 
Uneori, visele despre copii pot semnifica înțelegerea mai profundă a propriei personalități, descoperirea unor caracteristici personale pe care nu le cunoșteam.
Ce mai înseamnă când visezi copii sau bebeluși:
- Copil mic alăptat - fericire si belsug.
- Copil adoptat - nemulţumire.
- Copil alergând prin casă - afaceri norocoase.
- Adunare de mai mulţi copii - veşti interesante.
- Visezi că atingi un copil - eşti dominat de responsabilitate.
- Copil ascultător - afaceri rentabile.
- Copil bătut în public - suferi o ruşine.
- Naşterea unui copil - moarte.
- Doi copii - mari bucurii între soţi.
- Copii duşi de mână - sfârşitul unei afaceri norocoase.
- Fată - bucurie mare.
- Împăcare cu un copil - iniţiative rezonabile din partea ta.
- Copil frumos - satisfacţie, vei face cunoştinţă plăcută.
- Copil în curte - treci de pericole. 
- Copil în braţele unui bărbat - se va naşte un băiat.
- Copil în faşă - sănătate, bucurie.
- Copil jucându-se - înţelegere, dragoste, afacere bună - jucându-se mai mulţi - succese materiale - jucându-se cu el - bucurie, câştig.
- Copil la sân - fericire.
- Leagăn cu un copil - speranţa pentru viitor, succes la proiectele începute.
- Legănând un copil - speranţe mari în afacerea în curs.
- Lovind copilul - nedreptate.
- Mai mulţi copii la un loc - necazuri.
- Mână de copil - succes financiar.
-Mângâind un copil - îndoieli ce trebuiesc clarificate.
- Copil mic ţinut în braţe - necaz, ruşine.
- Copii foarte mici - sporirea familiei.
- De visezi că ai mulţi copii - la fel ai şi duşmani.
- Mustra un copil - perspective bune.
- Copil murind - câştig.
- O fată visând - cineva încearcă să te seducă
- Neglijezi un copil - lipsa de înţelegere, resentimente.
- Copil nou-născut - oboseală ce duce la deznădejde.
- Pantof de copil - promovare la serviciu. Sandale - vei primi sfaturi bune.
- Pedepseşti un copil - necazuri în domeniul financiar.
- Pieptăna un copil- relaţii bune în familie şi cu persoana iubită.
- Copil puternic - sănătate, ştii să te orientezi.
- Copil râzând - veste proastă.
- Stând lângă un nou-născut - mare bucurie.
- Copii vorbind între ei - veselie izbândă.
- Văzând copii legaţi - seninătate în familie.
- Te vezi copil in vis - începi o nouă legătură sentimentală. 
